
excite - возбуждать 
passionate - страстный 

He is passionate about technology.
I’m excited by building scalable systems and designing architectures that can handle millions of transactions efficiently.

paw - лапа
nails - когти

Would you like to eat with us tonight?
Would you like some coffee?
Do you mind if I use your phone changer?
Is it all right if I ... 
Is it OK if I ... 
Do you think I could ... 
Could you wait a moment, please?
Can you wait a moment? please?

also - también, además 
performance - производительность 
application performance - производительность приложения 

own - владеть
overtake - обгонять, обогнать 
cause - вызывать, становиться причиной 
invent - изобретать, придумывать 
disappear - исчезать, пропадать 
sink - тонуть 
rescue - спасать, выручать 
bother - беспокоить, надоедать 
accuse - обвинять 
fall - падать, проваливаться 
to warn - предупреждать
to damage - повреждать 
cover - покрывать, защищать 
injure - ранить, повреждать, травмировать 


//

